gravitational wave: space ripple
cosmology: universe story
cosmological: universe
supernova: whizz-bang
supernova: star pop
supernovae: star pops
astrophysics: space works
astrophysical: space workings
sun: hot plasma ball
star: far away hot plasma ball
stars: far away hot plasma balls
planet: blobby space thing
planets: blobby space things
planetary: blobby space thing-related
galaxy: star club
galaxies: star clubs
coronal: sun's plasma blancket
telescope: far-looker
cosmic: spacey
plasma: hot space stuff
jupiter: the big planet
moon: pal
moons: pals
exoplanet: far-off space things
spectroscopy: rainbow-watching
dark matter: mystery stuff
dark energy: very mysterious stuff
magnetic field: magical field
magnetosphere: magicsphere
vortex: swirly
quasar: far-away blinkey
redshift: far-awayness
photosphere: bright-bit
solar system: Earth friendzone
strong lensing: light bending
atmosphere: air-bubble
atmospheres: air-bubbles
solar:sunny
serendipitous:totally random
detailed:well thorough
predictions:wild guesses
model:vague idea
modelling:concocting vague ideas
insights:confusing claims
understanding:misunderstanding
modified:fudged
testing:breaking
searching:frantically searching
minor:boring
fundamental:vaguely important
results:spurious claims
dark energy:fictional nonsense
high redshift:far far away
what are:what the hell are
dynamics:twitchings
binary star:Tatooine
largest:fattest
observations:sly glances
flare: gas spark
survey: sneaky scouting
phenomena: happening times
phenomenon: happening time
experimental: fiddling about
ethanol: strong drink
astronomer: astrologer
astronomers: astrologers
astronomy: astrology
astronomical: astrological
astrology: astronomy
astrological: astronomical
@galaxymenagerie: My less exciting brother @galaxymenagerie
facilities: places to do stuff
complex: tricky
virtual reality: funny glasses
education: teachin'
method: ways of doin'
international: all-over-the-place
outreach: talkin' to the normal folk
MHD: plasma maths
carbon: charcoal
science: poking around
heating: gentle warming
universe: star warehouse
spectrum: rainbow
LIGO: laser gun
